11111111111111
10000000000001
11111111110001
10000000000001
10001111111111
100P0C0000E001
11111111111111