111111
1P0001
100001
100001
100001
1CCCE1
111111