1111111111111
1P10C010C01E1
1010101010101
1010101010101
1010101010101
1010101010101
1010101010101
1110101010101
1C0010C010001
1111111111111
