11111111111111111111111
100001000000000000000E1
10000100000000000000001
10000101000000000000001
10010101000000000000001
10010101000011000000001
10010101001000100000001
10010101010010010000001
1P010001010C01000000001
11111111111111111111111
